# Land Areas:
# A land area is 3 - 10 provinces

# From North to South
# Taken from: https://www.fas.harvard.edu/~chgis/japan/images/hall_medieval_prov.jpg

########################################
# Hokkaido					 		   #
########################################

oshima_peninsula_area = {
1 2 3 4 5
}

mutsu_area = {
6 7 8 9 10 
}

dewa_area = {
11 12 13 14 15 16 17 18 19 20 
}

sado_area = {
21 22 23 24 25 26 27 28 29 30
}

echigo_area = {
31 32 33 34 35 36 37 38 39 40
}

kozuke_area = {
41 42 43 44 45 46 47 48 49 50
}

shimotsuke_area = {
51 52 53 54 55 56 57 58 59 60
}

hitachi_area = {
61 62 63 64 65 66 67 68 69 70
}

shimosa_area = {
71 72 73 74 75 76 77 78 79 80
}

musashi_area = {
81 82 83 84 85 86 87 88 89 90
}

kazusa_area = {
101 102 103 104 105 106 107 108 109 110
}

awa_area = {
111 112 113 114 115 116 117 118 119 120
}

shinamo_area = {
91 92 93 94 95 96 97 98 99 100
}

kai_area = {
121 122 123 124 125 126 127 128 129 130
}

sagami_area = {
131 132 133 134 135 136 137 138 139 140
}

izu_area = {
141 142 143 144 145 146 147 148 149 150
}

suruga_area = {
151 152 153 154 155 156 157 158 159 160
}

totomi_area = {
161 162 163 164 165 166 167 168 169 170
}

mikawa_area = {
171 172 173 174 175 176 177 178 179 180
}

owari_area = {
181 182 183 184 185 186 187 188 189 190
}

mino_area = {
191 192 193 194 195 196 197 198 199 200
}

hida_area = {
201 202 203 204 205 206 207 208 209 210
}

etchu_area = {
211 212 213 214 215 216 217 218 219 220
}

hoto_area = {
221 222 223 224 225 226 227 228 229 230
}

kaga_area = {
231 232 233 234 235 236 237 238 239 240
}

echizen_area = {
241 242 243 244 245 246 247 248 249 250
}

omi_area = {
251 252 253 254 255 256 257 258 259 260
}

ise_area = {
261 262 263 264 265 266 267 268 269 270
}

shima_area = {
271 272 273 274 275 276 277 278 279 280
}

iga_area = {
281 282 283 284 285 286 287 288 289 290
}

#yamato cannon
yamato_area = {
291 292 293 294 295 296 297 298 299 300
}

# A kii area.
kii_area = {
301 302 303 304 305 306 307 308 309 310
}

yamashiro_area = {
311 312 313 314 315 316 317 318 319 320
}

wakasa_area = {
321 322 323 324 325 326 327 328 329 330
}

izumi_area = {
331 332 333 334 335 336 337 338 339 340
}

kawachi_area = {
341 342 343 344 345 346 347 348 349 350
}

settsu_area = {
351 352 353 354 355 356 357 358 359 360
}

tamba_area = {
361 362 363 364 365 366 367 368 369 370
}

tango_area = {
371 372 373 374 375 376 377 378 379 380
}

tajima_area = {
381 382 383 384 385 386 387 388 389 390
}

harima_area = {
391 392 393 394 395 396 397 398 399 400
}

mimasaka_area = {
401 402 403 404 405 406 407 408 409 410
}

inaba_area = {
411 412 413 414 415 416 417 418 419 420
}

hoki_area = {
421
}

bizen_area = {
422
}

# ;)
bitchu_area = {
423
}

bingo_area = {
424
}

izumo_area = {
425
}

iwami_area = {
426
}

aki_area = {
427
}

nagato_area = {
428
}

suo_area = {
429
}

hizen_area = {
430
}

chikuzen_area = {
449
}

buzen_area = {
450
}

chikugo_area = {
451
}

bungo_area = {
431
}

higo_area = {
432 
}

hyuga_area = {
433
}

satsuma_area = {
434
}

osumi_area = {
435 
}

iyo_area = {
436
}

tosa_area = {
437
}

sanuki_area = {
438
}

awa_area = {
439 440 441
}

awaji_area = {
442 443 444 445 446 447 448
}


# Sea Areas:
# No restriction on size.

japanese_sea_area = {
452 453 454 455 456 457 458 459 460 461 462 463 464 465 466 467 468 469 470 471 472 473 474 475 476 477 478 479 480 481 482 483 484 485 486 487 488 489 490 491 492 493 494 495 496 497 498 499 500 501 502 503 504 505 506 507 508 509 510 511 512 513 514 515 516 517 518 519 520 521 522 523 524 525 526 527 528 529 530 531 532 533 534 535 536 537 538 539 540 541 542 543
}
